human	uman	uman
child	tya	tya
big	gari	gari
small	tya	tya
water	awa	awa
1s	mi	mi
2s	tu	tu
3s	a	a
-PL	n	in
-GEN	a	a
NEG	na	na
and	ai	ai
or	oa	oa
zero	sir	siro
one	ai	ai
two	do	do
three	trin	tarin
four	tyar	tyaro
five	pan	pan
six	sys	syesu
seven	sat	sati
eight	it	ita
nine	noi	noi
ten	des	desa
100	san	san
1000	sar	sara
